Ashli	Guittet	aguittet0@stumbleupon.com
Lacy	Bevens	lbevens1@jimdo.com
Hedvige	Vevers	hvevers2@diigo.com
Joann	Blasiak	jblasiak3@spotify.com
Consalve	Yakobovitz	cyakobovitz4@tripadvisor.com
Ronald	Hartburn	rhartburn5@time.com
Frederico	Annies	fannies6@cdbaby.com
Queenie	Shallcrass	qshallcrass7@techcrunch.com
Claudia	Ilem	cilem8@phoca.cz
Marwin	Blasius	mblasius9@marriott.com
Scarlet	Lowrey	slowreya@oakley.com
Alyson	Tattersfield	atattersfieldb@discuz.net
Doria	Arnatt	darnattc@biglobe.ne.jp
Devinne	Taig	dtaigd@spiegel.de
Salmon	Gillicuddy	sgillicuddye@dot.gov
Pammie	Terrington	pterringtonf@ocn.ne.jp
Leontine	Groundwater	lgroundwaterg@sohu.com
Johnath	Dellar	jdellarh@yandex.ru
Erroll	Robilliard	erobilliardi@reuters.com
Giffie	Tennock	gtennockj@ox.ac.uk
Guillaume	Keri	gkerik@springer.com
Camella	Clardge	cclardgel@tinypic.com
Iosep	Oloshin	ioloshinm@washington.edu
